msk - Москва
spb - Санкт-Петербург
nsk - Новосибирск
eburg - Екатеринбург
kazan - Казань
nn - Нижний Новгород
chel - Челябинск
samara - Самара
omsk - Омск
rostov - Ростов-на-Дону
ufa - Уфа
krs - Красноярск
voronezh - Воронеж
perm - Пермь
volgograd - Волгоград
krasnodar - Краснодар
saratov - Саратов
tumen - Тюмень
tlt - Тольятти
izhevsk - Ижевск
sochi - Сочи
penza - Пенза
ul - Ульяновск
oren - Оренбург
astrahan - Астрахань
gelendjik - Геленджик
ivanovo - Иваново
barnaul - Барнаул
irkutsk - Иркутск
vladivostok - Владивосток
yar - Ярославль
habarovsk - Хабаровск
tomsk - Томск
nk - Новокузнецк
kemerovo - Кемерово
ryazan - Рязань
nabchel - Набережные Челны
lipetsk - Липецк
tula - Тула
kirov - Киров
cheb - Чебоксары
kaliningrad - Калининград
kursk - Курск
ulanude - Улан-Удэ
magnitogorsk - Магнитогорск
tver - Тверь
bryansk - Брянск
belgorod - Белгород
surgut - Сургут